1 1 1 1 1 4 4 12 4 4 1 1 1 1
2 0 0 1 1 4 0 0 0 4 1 0 0 4
7 0 0 1 1 3 0 0 0 3 1 0 0 8
2 0 0 0 0 0 0 0 0 0 0 0 0 5
10 0 0 0 0 0 0 0 0 0 0 0 0 5
2 0 0 1 1 3 0 0 0 3 1 0 0 4
11 0 0 4 1 4 0 0 0 4 1 0 0 4
4 6 6 4 1 4 0 0 0 4 1 0 0 4
1 1 1 1 1 4 4 13 4 4 1 0 0 9
1 1 1 1 1 1 1 1 1 1 1 1 1 1 

