1 1 1 1 1 4 4 7 4 4 1 1 1 1
2 0 0 1 1 4 0 0 0 4 1 0 0 4
7 0 0 1 1 3 0 0 0 3 1 0 0 8
2 0 0 0 0 0 0 0 0 0 0 0 0 5
7 0 0 0 0 0 0 0 0 0 0 0 0 5
2 0 0 1 1 3 0 0 0 3 1 0 0 4
7 0 0 4 1 4 0 0 0 4 1 0 0 4
4 6 6 4 1 4 0 0 0 4 1 0 0 4
1 1 1 1 1 4 4 7 4 4 1 0 0 9
1 1 1 1 1 1 1 1 1 1 1 1 1 1 

